grässlich - baisus
der Gatte, die Gattin - sutuoktinis, sutuoktinė
schlicht - paprastas
die Wirkung - poveikis
das Dach - stogas
der Tropfen - lašas
die Botschaft - žinia
kriechen - šliaužti
der Ablauf - įvykių eiga
der Aufsatz - rašinys
tauchen - nardyti
der Käfer - vabalas
der Leib - kūnas
blinzeln - mirkčioti
erwidern - atsakyti
schlecken - laižyti
der Köder - masalas
schlucken - ryti
sich erschöpfen - nusikamuoti
die Diele - grindys
das Geschöpf - būtybė
anhaben - dėvėti
das Entsetzen - siaubas
verletzen - užgauti
das Elend - bėda, rūpestis
demütig - humble, nuolankus
schlackern - drebėti
das Ziel - tikslas
schlingel - apkabinti
runzeln - suraukti
begegnen - sutikti (encounter)
der Klempner - santechnikas
das Gelingen - sėkmė, pasisekimas
retten - išgelbėti
gestatten - leisti
das Mitglied - narys
befugen - autorizuoti, leisti
das Gitter - grotos
die Waffe - ginklas
das Stroh - šiaudai
die Matte - kilimas
sperren - uždaryti (į kalėjimą)
weisen - parodyti
das Seil - lynas, virvė
verschwenden - iššvaistyti
schleppen - tempti, traukti, vilkti
kreischen - klykti
der Stier - bulius, jautis
ungeduldig - nekantrus
behaupten - teigti, tvirtinti
der Ghul - vampyras
vorkommen - pasitaikyti, būti; atrodyti
vertuschen - užtušuoti, paslėpti
der Schuppen - garažas
der Stall - tvartas
vermutlich - turbūt, matyt
rostig - surūdijęs
stemmen - įremti
schrumpfen - trauktis, sumažėti
aufmuntern - padrąsinti, pakelti nuotaiką
die Ziffer - skaitmuo
der Vorwurf - priekaištas
gilt - taikoma
stiften - sukelti
der Einband - knygos viršelis
fabelhaft - pasakiškas, nepaprastas
grimmig - nuožmus, įnirtingas
erbärmlich - pasigailėtinas, menkas
das Mitleid - gailestis, užuojauta
spärlich - skurdus, menkas, retas
zuständig - paskirtas, įpareigotas
der Schürhaken - žarsteklis
die Tatsache - faktas
stammeln - mikčioti
stoßen - stumti
weisen - rodyti
verzieren - pagražinti
die Schar - minia, būrys
die Schale - kevalas; dubuo
verteidigen - ginti
ungesetzlich - neteisėtas
der Schmetterling - drugys
erforschen - ištirti
erwähnen - paminėti
wecken - žadinti
der Topf - puodas
das Pulver - miltelis
lodern - liepsnoti
das Rohr - vamzdis
zerkratzen - subraižyti
schwach - silpnas
trommeln - būgnyti
genehmigen - pritarti, patenkinti
die Ehre - garbė, pagarba
unverschämter - įžūlus
der Dieb - vagis
barsch - šiurkštus (der - ešerys)
das Visier - taikiklis
schielen - šnairuoti
üppig - vešlus, gausus
sich ducken - susigūžti
die Schnecke - sraigė
reiben - trinti, braukti
ragen - išsikišti (protrude)
der Empfang - priėmimas
der Schein - banknotas
genießen - mėgautis
sich bemühen - stengtis
trennen - atskirti, skirti
verkünden - paskelbti
der Beifall - plojimai
mühelos - lengvas, be pastangų
die Gegenwart - dabartis; buvimas
wühlen - knisti, rausti
höhnisch - pašaipus, kandus
waten - bristi
öffentlich - viešas
der Becher - taurė
dehnen - driektis; ištempti
das Gleis - bėgių kelias
absperren - užrakinti, uždaryti
das Ziel - tikslas
das Eisen - geležis
in der Klemme sein - būti bėdoje
der Knopf - saga; mygtukas
der Antrieb - paskata, akstinas
trübe - apsiniaukę
anmutig - žavus
das Moor - pelkė
die Ameise - skruzdėlė
wimmern - vaitoti
das Lenkrad - vairas
stetig - nuolatinis, pastovus
die Sehne - sausgyslė
der Hagel - kruša
kippen - apversti
drohen - grasinti
bang - baikštus
uralt - labai senas
beitragen - prisidėti
die Duft - aromatas
der Kamerad - draugas, bičiulis
die Ausgabe - leidimas
schildern - aprašyti, pavaizduoti
das Bedauern - apgailestavimas, užuojauta
befugen - leisti
das Unheil - nelaimė, bėda
klopfen - mušti, belsti
taub - kurčias; sustingęs
derartig - toks, šitoks
die Obhut - globa
rein - grynas, visiškas
fürchten - baimintis
der Knall - trenksmas, pokštelėjimas
gewaltig - galingas; didžiulis
die Achsel - petys
das Gerücht - gandas
der Vortrag - paskaita, pranešimas
der Samt - aksomas
der Last - našta, krovinys
der Hafer - avižos
der Brei - košė
prallen - atsitrenkti, atsimušti
untersuchen - (iš)tirti
verdienen - užsitarnauti, nusipelnyti
grübeln - galvoti, mąstyti
zufällig - atsitiktinai
erstaunlicherweise - stebėtinai
erregen - sukelti; sujaudinti
charmant - žavus
die Eigenschaft - savybė
wesentlich - esminis, svarbus
der Bestandteil - sudėtinė dalis
bedecken - dengti
gießen - laistyti, pilti
der Hecht - lydeka (pike)
gründlich - nuodugnus, išsamus
verdunsten - išgaruoti
krabbeln - šliaužti, ropoti
schüchtern - drovus
dröhnen - dundėti, griausti
neidisch - pavydus
der Tritt - žingsnis
schleifen - galąsti
der Stapel - krūva
erwerben - įsigyti, nupirkti, užgyventi
die Leistung - pajėgumas, galingumas
kauern - sėdėti, tupėti
reizen - erzinti
der Kronleuchter - liustras, sietynas
brüllen - mykti
angeblich - tariamai
der Pfeil - strėlė
gähnen - žiovauti
die Genugtuung - pasitenkinimas
die Stufe - pakopa, laiptas
die Raupe - vikšras
quälen - kankinti, kamuoti
sausen - lėkti, dumti, švilpti
spucken - spjauti
erteilen - duoti, suteikti
großzügig - dosnus, kilniaširdiškas
bewundern - grožėtis, gėrėtis
wider - prieš, priešais
unwirsch - šiurkštus, atžarus
stützen - paremti
das Gebüsch - krūmynas
emsig - stropus, uolus
würgen - springti
übel - blogas, prastas
verkleben - užklijuoti
düngen - tręšti
winzig - mažytis
trübselig - liūdnas
der Knochen - kaulas
fetzen - suplėšyti
jäh - staigus, smarkus
das Gelingen - sėkmė
spähen - ieškoti
der Hieb - kirtis, smūgis
trennen - atskirti
einsetzen - panaudoti
die Wange - skruostas, žandas
stöbern - naršyti, ieškoti
das Unheil - nelaimė, bėda
der Zweck - tikslas, prasmė
tadeln - peikti, smerkti
der Erfolg - sėkmė, pasisekimas
der Ziegel - plyta, čerpė
die Schublade, das Schubfach - stalčius
hüpfen - šokinėti
bereuen - apgailestauti, gailėtis
geräumig - erdvus
behaglich - jauku, patogu
die Wirkung - veikimas, poveikis
verdorben - sugedęs, sugadintas
der Laib - kepalas
verwesen - pūti, trūnyti
behutsam - atsargiai
die Rippe - šonkaulis
schallen - aidėti, skambėti
der Kerl - vaikinas, vyras, bernas
sich bemühen - stengtis
säumen - supti, juosti
bewegen - judinti
riechen - užuosti; kvepėti
schmieren - užtepti, terlioti
der Feind - priešas
verstummen - nutilti
anlocken - vilioti, masinti
etliche - keletas
die Einschätzung - įvertinimas
verabscheuen - bjaurėtis, neapkęsti
der Vorfall - atsitikimas
keifen - ginčytis
verdächtig - įtartinas
beseitigen - panaikinti
geduldig - kantrus
zugeben - sutikti, pripažinti
geheim - slaptas
stammen - būti kilusiam
der Angriff - užpuolimas
das Mittelalter - viduramžiai
anderthalb - pusantro
zanken - bartis, kivirčytis
uralt - labai senas
die Unterlagen - dokumentai
die Tatsache - faktas
derart - taip, tiek
damalig - tuometinis
grausam - žiaurus
einträchtig - vieningas, darnus
auslesen - atrinkti, išrinkti
der Gründer - įkūrėjas
der Erbe - paveldėtojas
das Erbe - palikimas
in der Lage sein - sugebėti
erlauben - leisti
eifrig - uolus, stropus
vermuten - spėti, manyti
die Wache - sargyba, sargybinis
die Fensterscheibe - lango stiklas
der Faden - siūlas, gija
das Seil - lynas, virvė
die Spinne - voras
der Abstand - atstumas, nuotolis
vermeiden - išvengti
das Waschbecken - kriauklė
die Verzweiflung - nusivylimas, neviltis
das Verhältnis - santykis, ryšys
erbost - įpykęs, įniršęs
vermasseln - susimauti
klecksen - terlioti
der Abschaum - putos, nuoviros; atmatos, padugnės
beweisen - įrodyti
tückisch - klastingas
blöd - kvailas, paikas
nötigen - priversti
sich weigern - vengti, išsisukinėti
stechen - įdurti, įgelti
die Kehle - gerklė
der Pelz - kailis
schlau - gudrus, apsukrus
falten - sulenkti, lankstyti
das Bedürfnis - poreikis
der Geier - (vulture) maitvanagis
die Abbildung - iliustracija
der Vorrat - atsargos
klauen - nukniaukti, nudžiauti
die Zutaten - ingredientai
das Gewitter - audra, perkūnija
fordern - reikalauti
ausweichen - trauktis, užleisti kelią
geschweige denn - nekalbant jau apie tai, kad
basteln - meistrauti, dirbinėti
der Ärmel - rankovė
albern - paikas, naivus
quälen - kankinti, kamuoti
zielen - taikyti
der Schleier - šydas, skraistė
spritzen - purkšti, laistyti
der Überrest - likutis, liekana
lahm - šlubas
ansonsten - priešingu atveju
ziellos - betikslis
scheußlich - šlykštus, bjaurus, baisus
der Rachen - gerklė
scharen - burti, telkti
der Verdacht - įtarimas
würgen - smaugti
der Sklave - vergas
der Krug - ąsotis, puodynė
edel - taurus
tapfer - drąsus
dicht - arti
strecken - ištiesti
versperren - užtverti, užstoti
gekünstelt - nenatūraliai
sich vergewissern - įsitikinti
das Geständnis - prisipažinimas
schleichen - sėlinti
platzen - trūkti, plyšti
der Handel - prekyba
der Vorrat - atsargos
der Aufruhr - maištas
spotten - tyčiotis, juoktis
der Prügel - lazda
fegen - šluoti; dumti, lėkti
das Brett - lenta
gebieten - įsakyti, liepti
die Einzelheit - smulkmena, detalė
das Schwert - kardas
die Bühne - scena, teatras
eitel - pasipūtęs
die Schlacht - kautynės, mūšis
sich raufen - peštis, muštis
hämisch - piktdžiugiškas, klastingas
zerren - patempti
der Schlauch - žarna
die Gabe - dovana, auka
boshaft - piktas, pašaipus
das Gehirn - smegenys
der Dachs - barsukas
eng - ankštas, artimas
das Opfer - auka
senken - nuleisti, sumažinti, nunarinti
hetzen - pjudyti, kurstyti
der Erfolg - sėkmė, laimėjimas
die Pranke - letena
das Gespenst - vaiduoklis, šmėkla
quellen - teketi, laseti
meucheln - nužudyti
ehemalig - (anksčiau) buvęs
das Bord - lentyna
der Fimmel - pamišimas
würgen - smaugti
sich sputen - paskubėti
die Treue - ištikimybė
jäh - staigus, ūmus
verlegen - drovus, susigėdęs
angreifen - užpulti, atakuoti
sich fügen - atsitikti
das Verhalten - elgesys
der Auftritt - pasirodymas (scenoje)
der Betrag - pinigų suma
das Betragen - elgesys
schieben - stumti
der Zettel - lapelis, raštelis
prächtig - puošnus, prašmatnus
schmücken - puošti
sachlich - dalykiškas, konkretus
gierig - godus, gobšus
erwürgen - pasmaugti
verblüffen - sugluminti
gelungen - sėkmingas
schäumen - putoti
widerlich - bjaurus, šlykštus
klemmen - sugnybti
ahnen - nujausti, numanyti
der Haarschnitt - šukuosena
lockern - atleisti, atpalaiduoti
steif - kietas
vernichten - niekinti
prasseln - spragsėti, barbenti
die Untersuchung - tyrimas
das Amt - įstaiga, tarnyba
verursachen - sukelti
kichern - kikenti, krizenti
der Verdacht - įtarimas
der Genuß - malonumas, pomėgis
verraten - išduoti
der Landsitz - dvaras
die Arznei - vaistas
schluchzen - kūkčioti, raudoti
das Fell - kailis, oda
die Spur - pėdsakas
genesen - pasveikti, taisytis
der Abstand - atstumas, nuotolis
reglos - nejudamas
die Angelegenheit - reikalas, dalykas
schäbig - vargintas, skurdus
beschlagnahmen - konfiskuoti
die Auszeichnung - apdovanojimas	
verweisen - išvaryti
dennoch - vis dėlto
verstauen - sukrauti, patalpinti
beleidigen - užgauti, įžeisti
endgültig - galutinis
die Schurke - niekšas, sukčius
vernünftig - protingas
irren - klaidžioti, klysti, apsirikti
die Überraschung - nuostaba, nustebinimas
griesgrämig - niūrus, niurzgus
platzen - plyšti, sprogti
pökeln - sūdyti
vergeblich - tuščiai, bergždžiai
der Abzug - atskaitymas, nuolaida
schnauben - šnopuoti, alsuoti
verstoßen - nusižengti, pažeisti
ermahnen - paraginti, paskatinti
die Widmung - paskyrimas, dedikacija
der Bruchteil - dalis, dalelė
das Waisenhaus - našlaičių prieglauda
die Vorliebe - potraukis, pomėgis
lärmend - triukšmingas
beeinflussen - paveikti
sämtlich - visi (be išimties)
trocken - sausas
wehen - pūsti, plevėsuoti
schaufeln - kasti (semtuvu)
schwatzen - plepėti, taukšti
der Trost - paguoda
die Traube - vynuogės
verdächtigen - įtarti
das Eingeweide - viduriai
die Locke - garbana
begleiten - palydėti
hinzufügen - pridurti, pridėti
das Vorkommnis - įvykis
kläffen - loti
zucken - krūptelėti, gūžtelėti
beinahe - beveik
üble - blogas
das Ruder - irklas
knurren - urgzti
der Verlust - netektis, nuostolis
zottig, zottelig - gauruotas







