vielerlei - visoks
erheblich - iš esmės
brüllen - riaumoti
erwähnen - paminėti
der Wecker - žadintuvas
das Merkmal - ypatybė
die Last - krovinys, našta
verderben - sugadinti
der Käfer - vabalas
der Reißverschluss - užtrauktukas
absichtlich - tyčia
widerspenstig - nepaklusnus
beschweren - skųstis
der Hinweis - užuomina
zwingen - priversti
hämisch - kenkėjiškas
der Bursche - bičiulis
wiegen - sverti
widerwillig - nenoriai
der Flur - koridorius
beklagen - skųstis
die Anstalt - institucija
der Vorwurf - kaltinimas
die Weste - liemenė
winzig - mažytis
der Schweif - uodega
verstummen - nutilti
die Lage - padėtis
der Beutel - krepšys, piniginė
der Reifen - padanga





